17 21
FFFFFFFPFFFFMMMMMFFPP
FFFFFPFFFFFMFMMMMFPFF
FFFPPFPPFFPFFMMMMFFFP
FFPPPPFFPPMMMMMMMffFF
PPPFPPPPPMMMMFMMPPPFF
PfffPPfPMMMMMFMPPPPFF
FfffPPPPMMMMFMPPFPPPF
PPPPPPMMMMMMMPPPPFPFF
PPPPPMMFFMMMMPPPPPPFF
FPPPMMFFFFMPPPPFPFPFF
PPPPPMMMFPPPFPPFPPPFF
PFPPPPfPPPPFFPFPPPPPF
PPPPPPfPPFPPPPFPPPPFF
FFFPPPPFPFPPPFPPFfffP
FPFPFPPPPPPFPPPPPfffF
FPFFPPPFFPPPPPPPPPFPF
FFFPFPFFPPFFFPFFFFFFF