16 17
MPPMMFFFPFFFPFPPP
fPPfPPFPFFPFMPPPP
PPPPPPPFPFMMMPPPP
PPPPPPMFMMMMFFPPP
FPPPPPPfMMMMFPPPP
MFPPPPPPMMMMMFFPP
fffMMPPPPMMMMFPFP
fffMPfFPPFMMMMFFP
PPPMPPFPPPPMMMMFP
MPMMMMFFPPPMMMMMP
MPFMMMMfFPPPMMMMM
MFPMMMMMPPPPPPMPP
PPPPMMMMMPPPfPPPP
ffPPPMMMPPPPPPPFF
FPPPPPPPfPPPFPPPP
PPPPPPPfPPPPPPFPP